111111111111111111111111111
10000000000C000011C00000001
1P0000000000000011000000001
1000C0000000C0001100C0E0001
10000000C000000000000000001
100000000000000000000000C01
100000000000000000000000001
100101011101100011000111001
100111011000100001000101001
100101011100111001110111001
10000000000C000000000000001
111111111111111111111111111