111111111111111111111
100000000000100000C01
1000C0010000100P00001
1000000100C0100000001
10000001000010000C001
1000C0010000000000001
111111111111111111111