111111111
10P00C001
1100CC001
1EC000001
111111111