111111111111111111111111111
10000000000C000011C00000001
1P0000000000000011000000001
1000C0000000C0001100C0E0001
100000000000000000000000001
100000000000000000000000001
100000000000000000000000001
111101000001000100010101111
1110010000111000101C0101C11
11000111010C0100010001C1111
100C0000C000000000000000001
111111111111111111111111111