111111111111111111111111111
10000000000C000011C00000001
1P0000000000000011000000001
1000C0000000C0001100C0E0001
100000000000000000000000001
111111111111111111111111111
1111C11111C1111111111111111
11111C111C11111111111111111
111111C1C111111111111111111
1111111C1111111111111111111
1111111C1111111111111111111
111111111111111111111111111