11111111111111111111111
10000000000001000000C01
10000C0010000100P000001
10000000100C01000000001
100E00001000010000C0001
10000C00100000000000001
11111111111111111111111